1111111111111111111111
1929192919291929192911
1219291929192919291991
1212111211121112199121
1219911992292299112121
1211211121121121199121
1219911991131199121121
1212111211121112199121
1219911992292299112121
1211211121121121199121
1219911991121199121121
1212111211121112199121
1219911992292299112121
1211211121121121199121
1219911991121199121121
1212111211121112199121
1999922922292229112121
1121211211111112112121
1121922911111112112121
1121211210000112112121
1194911218765009229291
1121922910000112112121
1121211211111112112121
1999922992292299199121
1219911991121199121121
1211211121121121199121
1219911992292299112121
1212111211121112199121
1219911991121199121121
1211211121121121199121
1219911992292299112121
1212111211121112199121
1219911991131199121121
1211211121121121199121
1219911992292299112121
1212111211121112199121
1219291929192919291991
1929192919291929192911
1111111111111111111111