1111111111111111111111
1922922929229292292291
1211211212112121121121
1311211319229121121131
1211211212111121121121
1922922929222292292291
1211211111111111121121
1211929222222229291121
1922912111111112199291
1211119292292929112121
1219229121121212112121
1929112121121212112121
1211119292292929112121
1922229111111119299291
1211119292222929121121
1219229121111212199121
1212112121111212112121
1212119292222929112121
1219229111111112199121
1211112110000112121121
1924929118765009292291
1211212110000112121121
1211212111111112121121
1219919292222929199121
1212112121111212112121
1219912121111212199121
1211219292222929121121
1922929121111119292291
1211212192922912121121
1211212121211212121121
1929929121311212199121
1212112199929912112121
1212112112112112112121
1929929929229299299291
1211211212111121121121
1311211219229121121131
1211211211112121121121
1922922922229292292291
1111111111111111111111