1111111111111111111111
1922922911111192292291
1211211922222291121121
1211211111111111121121
1992922922229292292291
1121111211112121121121
1121111219229121121131
1192292912112121121121
1121121212112121121121
1121131219229192992991
1121121211112121211211
1121121922929291991211
1121121111211111192911
1992292222911111111211
1211111111922222222911
1211111111211111111211
1922222911211111119991
1211111922922229112121
1922222911111112112121
1211111210000119229121
1924222918765009119291
1211111210000119229121
1922922911111112112121
1211211922911119112121
1211211111922229229991
1992992222911111111211
1121121111211111192911
1121121922929291991211
1121121211112121211211
1121131219229192992991
1121121212112121121121
1192292912112121121121
1121111219229121121131
1121111211112121121121
1992922922229292292291
1211211111111111121121
1211211922222291121121
1922922911111192292291
1111111111111111111111